100
100
PPPPPPPPPPPPPPPPPPPPPPPPPPPPPPPPPPPPPPPPPPPPPPPPPPPPPPPPPPPPPPPPPPPPPPPPPPPPPPPPPPPPPPPPPPPPPPPPPPPP
PPPPPPPPPPPPPPPPPPPPPPPPPPPPPPPPPPPPPPPPPPPPPPPPPPPPPPPPPPPPPPPPPPPPPPPPPPPPPPPPPPPPPPPPPPPPPPPPPPPP
PPPPPPPPPPPPPPPPPPPPPPPPPPPPPPPPPPPPPPPPPPPPPPPPPPPPPPPPPPPPPPPPPPPPPPPPPPPPPPPPPPPPPPPPPPPPPPPPPPPP
PPPAAAAAAAAAAAAAAAAAAAAAAAAAAAAAAAAAAAAAAAAAAAAAAAAAAAAAAAAAAAAAAAAAAAAAAAAAAAAAAAAAAAMMMMMMMMMMMPPP
PPPAAAAAAAAAAAAAAAAAAAAAAAAAAAAAAAAAAAAAAAAAAAAAAAAAAAAAAAAAAAAAAAAAAAAAAAAAAAAAAAAAAMMMMMMMMMMMMPPP
PPPAAAAAAAAAAAAAAAAAAAAAAAAAAAAAAAAAAAAAAAAAAAAAAAAAAAAAAAAAAAAAAAAAAAAAAAAAAAAAAAAAMMMMMMMMMMMMMPPP
PPPAAAAAAAAAAAAAAAAAAAAAAAAAAAAAAAAAAAAAAAAAAAAAAAAAAAAAAAAAAAAAAAAAAAAAAAAAAAAAAAAAMMMMMMMMMMMMMPPP
PPPAAAAAAAAAAAAAAAAAAAAAAAAAAAAAAAAAAAAAAAAAAAAAAAAAAAAAAAAAAAAAAAAAAAAAAAAAAAAAAAAAMMMMMMMMMMMMMPPP
PPPAAAAAAAAAAAAAAAAAAAAAAAAAAAAAAAAAAAAAAAABBKBBAAAAAAAAAAAAAAAAAAAAAAAAAAAAAAAAAAAAMMMMMMMMMMMMMPPP
PPPAAAAAAAAAAAAAAAAAAAAAAAAAAAAAAAAAAAAATBABBBBBBAAAAASSAASAAAAAAAAAAAAAAAAAAAAAAAAMMMMMMMMMMMMMMPPP
PPPAAAAAAAAAAAAAAAAAAAATAAAAAAAAAAAAAATTTBBABABABBAASSSGSSSAAAASSSAAAAAAAAAAAAAAAAMMMMMMMMMMMMMMMPPP
PPPAAAAAAAAAAAAAAAAAATTTTAAAAAAAAAAASSSSBBBBABABABBBBSGGGGGGGGGSSSSBBAAAAAAAAAAAAAMMMMMMMMMMMMMMMPPP
PPPAAAAAAAAAAAAAAAAATTBTTTTTTTAAAAASSSGGGSSBBABABSSGGGGGGGGGGGGGSBBBAAAAAAAAAAAAAMMMMMMMMMMMMMMMMPPP
PPPAAAAAAAAAAAAAATTTTTTTTBTTTTTAASGGGGGGGGGSSBABSGGGGGGGGGGGGGGGAAAABTAAAAAAAAAAAMMMMMMMMMMMMMMMMPPP
PPPAAAAAAAAAAAAATTBTTTAATTTTTTTASGGGGGGGGGSSBBASGGGGGGGGGGGGGAAAGBBBTAAAAAAAAAAAAMMMMMMMMMMMMMMMMPPP
PPPAAAAAAAAAAAAATTTTTSSSSSTTTGGGGGGGGGGGGSSBBAXGGGGGGGGGGGGGAGGGSSBBTAAAAAAAAAAAAMMMMMMMMMMMMMMMMPPP
PPPAAAAAAAAAAAAATTBTTSSKSSTTGGGGGGGGGGGGAAAAABGGGGGGGGGGGGGGAGGGGGSBTAAAAAAAAAAAAMMMMMMMMMMMMMMMMPPP
PPPAAAAAAAAAATTTTTTTTTTTTTTTGGGGGGGGGGAAAGGGGGGGGAGGGGGGGGGGAGGGGGGSSAAAAAAAAAAAAMMMMMMMMMMMMMMMMPPP
PPPAAAAAAAAABBTTBTTTTTTTTTTTBBBBSSGGGGAGAGGGGGGGAGGGGGGGGGGGAGGGGGGBBSAAATSSTAAAAMMMMMMMMMMMMMMMMPPP
PPPAAAAAAABBBBTTTTTBTTTTTTTBBBBBBSSGGGAAAGGGGGGGGGGGGGGGGGGGAGGGGGGGGBSSAATTAAAAAAMMMMMMMMMMMMMMMPPP
PPPAAAAAAABBBBBBBTTTTTTTAATTTTBBBBSSGGAGGGGGGGGGGGGGGGGGGGGGAGGGGGGGGGBSSAAAAAAAAAAMMMMMMMMMMMMMMPPP
PPPAAAAAAABBBBBBBBAAAAAAAAAAAAAATBBBSGAGGGGGGGGGGGGGGGGGGGGGAGGGGGGGGGBBSAAAAAAATTAAMMMMMMMMMMMMMPPP
PPPAAAAAAABBBBBBBAAAABAAAABAAAAAAATBSGAGGGGGAGGAAGGGGXSSGGGGAGGGGGGGSSSSSAAAAAAAAAAAMMMMMMMMMMMMMPPP
PPPAAAAAAABBBBBBAAAAAAAAAAAAAAAAAAAASSAGGXGAAAAAAGGGGSSDGGGAGGGGGGGSSSSSSSBBBSSSSSAAMMMMMMMMMMMMMPPP
PPPAAAAAAABBBBBBAAAAAAAABBAAAAAAAAAAAABBBGGGGGGAGGGGGGGGGGGAGGGGGGGSSSSSBBBBBBBBBBSAAMMMMMMMMMMMMPPP
PPPAAAAAAAABBBBAAAAAAAAABBBAAAAAABAAAABBSSGGGGGAAGGGGGGGGGGGGGGGGGGSSSBBBBBBBBBBABBBBMMMMMMMMMMMMPPP
PPPAAAAAAAAABBBAABBAAAAABBBBBBAAAAAAAABBBSGGGGGAGGGGGGGGGGGGGGGGGGGSSSSBBBBBBBBBAAABBMMMMMMMMMMMMPPP
PPPAAAAAAAAABBBAABBAAAAAAAABBBAAAAAAAAABBBGGBBASGGGGGGGGGGGGGGGGGGGSSSSBBBBBBBBBAABTTMMMMMMMMMMMMPPP
PPPAAAAAAAABBBBAAAAAAAAAAAAAAAAAAAAAAAAABBSBBABSSGGGGGGGGGGGGGGGGGGSSSSBBBBBTTBBTTTTMMMMMMMMMMMMMPPP
PPPAAAAAAABBBBBAAAAAAAAAAAAAAAAAAAAAAAAABBBBABBSSGGGGGGGGGGGGGGGGGGSSXBBBBTTTBBTTTBBMMMMMMMMMMMMMPPP
PPPAAAAAAABBBBBAAAAAAAAAAAABAAAAAAATAABABBBBABBBSGGGGGGGGXGGGGGGGGGSSSSBBTTTTBTTTTBBMMMMMMMMMMMMMPPP
PPPAAAAAAAABBBAAAAAAAAAAAABBAAAAAAABBBBABBBABBBBGGGGGGGGGGGGGGGGGGSSSSSSBBTTTTTTTTTTMMMMMMMMMMMMMPPP
PPPAAAAAAAABBAAAAAAAAAAAAAABAAAAXBBBBBBABBBABBBSGGGGGGGGGGGGGGGGGGSSSSBBBBTTTTTTTXTTTMMMMMMMMMMMMPPP
PPPASAAAAAAABBAAAAAAAAAAAAAAAAABBBBBBBBAAAABBBBSGGGGGGGGGGGGGGGGGSSSSSSBBTTTTTTTTTTTBTTBBMMMMMMMMPPP
PPPAAAAAAAABBBABBBAAAAAAAAAABBBBBBBBBAAABBBBBBSSGGGGGGGGGGGGGGGGGSSSSSSSBBTTTTTTTTTBBBBBBBMMMMMMMPPP
PPPAAATAAAABBBAAAAAAABBBBBBBBBBBBBAAAABBBBBBBBSGGGGGGGGGGGGGGGGGSSSBBSSSSSTTTTAKTTTBABTBBMMMMMMMMPPP
PPPAAATTAAABBBBAAAAABBBBBBBBBBBAAAABBBBBBBBBBSSSGGGGGGGGGGGGGGGSSSBBBBBBSSBTTTTTBTTBSTTBBMMMMMMMMPPP
PPPAAAAAAAABBBBBBBBBBBBBBBTBBBAABBBBBBBBBBBBBBSSGGGGSSGGGGGGGGSSBBBABBBSSSSSBBSSBBBBBTBBMMMMMMMMMPPP
PPPAAAAAAAAAAAAAAAAAAAAAAAAAAAABBBBBBBBBBBBBBBBBBBBSSBSGGGGGGAABBBBBBBSSSSBBABSSSSBBBBBBMMMMMMMMMPPP
PPPSSAAAAAABBBBBBBBBBBBBBBBBBBABBBBBBBBBBBBBBBBBBBSBBBSGGGGSSSSAAABBBSSSSSSSSBBBSSSSSSBBBMMMMMMMMPPP
PPPSAAAAAAAATTBBBBBBSSSSSSSSBBABBBBBBBBBBBBBBBBBBSBBBBBSGGSSSBBBBBAAATTASSSSSSSSSSSSSSSSSSMMMMMMMPPP
PPPSAAAAAAAAATBBBBBBSBBBBBSSSBABBBBBBBBBBBBBBBBBSBBBBBBBSSSSBBBBBBBBTTTTAATAAAAAAASSSSSSSBBBMMMMAPPP
PPPSAAAAAAAAATBBBBBBSBBBBSBBSSASSSSSSSXSSBBBBBSSBBBBBBBSSSSBBBSBBBBXTTTTTTATTTTTTAAASSSSBBTBBMMAAPPP
PPPAAAAAAKBBXBBBBBBBSBBBBBBBBBABBBBBBBDSSXSSSSSBSBBBSBBBBSSSBBSBBBBTSTTTTTTTTTTTTTTAAAAAAABBMAAAAPPP
PPPAAAAADSSBBBBBBBBSTTTTSTTSBBABBBBBBBBBBBBBBBBSSBBSXBBBBBBSBBBBBBTTTSTTTTTTSSSTTTTTTTTTTTAAAAAAAPPP
PPPAAAAAASSBBBBBBBSSSSTTSTTTSBABBBBBBBBBBBBSBSMMMSSBBBSBBBBBSBBBBTTTTTSSTTTTSSSTTSTTTSSTTTAAAAAAAPPP
PPPAAAAAAAAASTTTTTTTTTTTTTTTXAAKBBBBBBBBSSMXMMMPMMMSSSSSBBSBBBBTTTTTTTSSTTTTSSSTTSTTTSSTTAAAAAAAAPPP
PPPAAAAAAATTTTTTTTTTTTTTTTTTASSABBBBBBBSSSMPPPPPPPMMMMSSSBBBBBBTTTTTTTTTTTTTTTTTSSBBTTTAAAAAAAAAAPPP
PPPAAAAAATTTTTTTTTTTTTTSSTTTASSABBBBBBBSSMMPPPPPPPPPPMMSSSBBBBTTXTTTTTTAATSTTTTTSBBBBBBAAAAAAAAAAPPP
PPPASAAATTTTTTTSSTTTTTTSSTTBASSABBBBBBBSMMPPPPPPPPPPPPMMSSBBXSSSSTTSSSSSSSSSSTTSSBBBBBBAAAAAAAAAAPPP
PPPASAAATTTTTTTTTTTTTTTTTTBBDXABBBBBBBSSMPPPPPPPPPPPPPPMMSBBBSSDSTTTTTTTTTTTTTTSAXSSBBBKAAAAAAAAAPPP
PPPSAAATTTSTTTTTTSSSTTTTTBBBBBBABBBBBSSMMPPPPPPPPPPPPPPPMSSBBBBBTTTTTTAATTTTTTTSASSDAAAAAAAAAAAAAPPP
PPPAAAASTTTTTTTTTTTTTTSBBBBBBBBBAAASSSMMPPPPPPPPPPPPPPPPMSSBBBBBBBAAABAAATTTTTAAAASAASAAAAAAAAAAAPPP
PPPAAAAABBTTBBTTTTTTTSBBBBBBBBBBBBBSSMMPPPPPPPPPPPPPPPPPMSSBBBBBBBBAAAAAAAAAABBAASSSSSAAAAAAAAAAAPPP
PPPAAAASSBBBBBBTTTTTSBBBBBSBBBBBBBBSMMPPPPPPPPPPPPPPPPPPMMSSBBBBBBBABBBAAAAAABBSAASAASAAAAAAAAAAAPPP
PPPAAASSBBBBBBBBBBBBBBBBBBBBBBBBBBSSMPPPPPPPPPPPPPPPPPPPPMSSBBBBBBBBABBBBBBSSBBBSSSKAAAAAAAAAAAAAPPP
PPPAAASBBBBBBBBBBBBBXBBBBBBBBBBBBBSSMPPPPPPPPPPPPPPPPPPPPMSSBBBBBBBBABBBBBBBBBBBSXAAAAAAAAAAAAAAAPPP
PPPAAASBBBBBSSBSSSSBBBBBBBBBBBBSBBSSMPPPPPPPPPPPPPPPPPPPMMSSBBBBBBBBBABBBBBBBBBBAASSAASSAAAAAAAAAPPP
PPPAASSBBSSBBSBBBBBBBBBBBBBBBBBBBBSSMPPPPPPPPPPPPPPPPPPPMSSSBBBBBBBBBABBBBBBBBAASBSSAASSAAAAAAAAAPPP
PPPAASSBBSSBBSBBBBBSSBBBBBBBBBBBBSSSMMPPPPPPPPPPPPPPPPPPMMSSBBBBBBBBBBAABBBBBAASBBSSASAAAAAABBAAAPPP
PPPAASSBBSSAAASSBBBBBBSBBBBBBBSBBBSSSMMMPPPPPPPPPPPPPPPPPMSSBBBBBBBBBBAAAAAAASSBBBAASSSAAAAABBBAAPPP
PPPAASSKBBSATABBBBBSSSSBBBBBBSBBBBBSSSSMMPPPPPPPPPPPPPPPPMSSBBBBBBBBBBBAXSSSSBBBAABBBBBBAAAAASAAAPPP
PPPAASSBBBSAAABBBBSSBSSSSSSBBSBBBBBSSKDSMMPPPPPPPPPPPPPPPMSSBBBBBBBBBBBBASBBBBBAABBBBBBBBAAAAAAAAPPP
PPPAAASBBBBBBBABSSSAAAAABSSSSAABBBBSSSXSSMMPPPPPPPPPPPPPPMSSBBBBBBBBBBBBBAABBBAABBBBBBBBBSAAAAAAAPPP
PPPAAASSBBBBBBSAAAAABSBBAAAAABBAAAAAASBBBSMMMMPPPPPPPPPPPMSSBBBBBBBBBBBBBSBAAAABBBBBBBBBBSAAAAAAAPPP
PPPAAASSBBBBBBBBBBBBABBBBBBBBBBBSSSSSASSBSSSSMMMMMPPPPPPPMSSBBBBSBSBBBBBBSBBBBBBBBBBBBBBBBAAAAAAAPPP
PPPAAAAASSBBBBBBXBBBBABBBBBBBBBSSSSSSASSSBBSSMMMMMMMMMPPMMSSTTSSSSSSSBBBBSBBBBBBBBBBBBBBBAAAAAAAAPPP
PPPAAAAAASSBBBBBBBBBBABBBBBBBSSSSSSTTSAASSBBSMSSSSMSSMMMMSSSTTTSSTSSSSBBBSBBBBBBBBBBBBBBAAAAAAAAAPPP
PPPAAAAAAASBBBBBBBSSSABBBBSSSSSSSSSTTTSSAAAAAMSKDSMBBASSSSSSSTTSSTTTSSSSSBBBBBBBBBBBBBBSAAAAAAAAAPPP
PPPAAAAAAAASSBBBBBBSSSABBSSTSSSSSSSTTTSSAAAAAMSDKBMBBATTTSSSSTTSSTTTTTSSBBDBBBBBBBBBBSAAAAAAAAAAAPPP
PPPAAAAAAAAAASBBBBBBBBABBSSTSTSTSTSSTTSSSAAAMMSSSSMMAASSTTTTTTTSSSSSSSSXSSSSSXBBBBBBBAAAAAAAAAAAAPPP
PPPAAAAAAAAAASBBBBBSSBABSSSSTSTSTSTSSSSSSBAMMXSSSSSMMAASSTTTTSSSTTTTSSSSSASBBBBBBBBBSAAAAAAAAAAAAPPP
PPPAAAAAAAAAASBBBBBBSBASSSSBDBXTSTSSSSSSSSAMSSBKDSSXMSASSSSSSSSSSSSSSSSSBBBBBBBBBSBSAAAAAAAAAAAAAPPP
PPPAAAAAAAAAAAABBBBBBBBASSXBBBTSTSTSSSSSSSSSSSBDKSSSSSSSSSTTSSSSSSSSTTTSBBBBBSSSAAAAAAAAAAAAAAAAAPPP
PPPAAAAAAAAAAAASBBBBBBSSASTTSTSTSSSXSSSSSBAAMMMSSMMMAAATTTTTSSSSSSTTTTTTBBBBBSAAAAAAAAAAAAAAAAAAAPPP
PPPAAAAAAAAAAASSBBBBBSSSSAASSSBSSSSSSSSBBBBAAAMSSMAAAASSSSSSSTTTSSTSSSSSSSBBAAAAAAAAAAAAAAAAAAAAAPPP
PPPAAAAAAAAAASSSSSBBSSSSSSSASSBBSSSSSSSBBAAAAAMSSMAAABAABBSBSTTTSTTSSSSSSSSSAAAAAAAAAAAAAAAAAAAAAPPP
PPPAAAAAAAAAASBBBBSBSSSSSSSBAAAAAAAAAAAAABBBBAASSXBBBBBBASSSSSSSSTTSSSSSSSSAAAAAAAAAAAAAAAAAAAAAAPPP
PPPAAAAAAAAAASBBBBBSSSSSSSSBBBBBBBBBBBBBBBBBBBBBBBBBBBBBBAAAAASSTTTSSSSSSSSAAAAAAAAAAAAAAAAAAAAAAPPP
PPPAAAAAAAAAASBBBBBASSSSSSBBBBBBBBBBBBBSSBBBBBBBBBBBBBBBBBBBBBAATTTTTSSSSSAAAAAAAAAAAAAAAAAAAAAAAPPP
PPPAAAAAAAAASBBBBSSBSSSSSSSBBBBBBBBBBBBBBBBBBBBBBBBBBBBBBBBBBBBAATTTTSSSSSAAAAAAAAAAAAAAAAAAAAAAAPPP
PPPAAAAAAAASSBBBBSSSSSBABSSBBBBSBBBBBBBBBBBBBBBBBBBBBBBBBBBBBBBBBAAAAAAASSAAAAAAAAAAAAAAAAAAAAAAAPPP
PPPAAAAAAAASSBBSSSSSSSSBSAAABBBSBBBBBBBBSSSBBBBSSSSBBBBBBBBBBBBBBAAABBBSAAAAAAAAAAAAAAAAAAAAAAAAAPPP
PPPAAAAAAAASSSBBSSBBBBBBBSBBABBBSBBBBBBSBSSSBBBDSSXBBBABBBBBAABBBAAAABBSAAAAAAAAAAAAAAAAAAAAAAAAAPPP
PPPAAAAAAAASSSSMMMSBBBBBBSBBAABBBBBBBBBSBBSBSBBBBBBBBBBBBBAABABBBBBBBSAAAAAAAAAAAAAAAAAAAAAAAAAAAPPP
PPPAAAAAAAASMXMMDMSSSSBBBSBBBABBABBBBBSSBBBBSBBBBBBBBBBBBABABBBABBBBXAAAAAAAAAAAAAAAAAAAAAAAAAAAAPPP
PPPAAAAAAAASMMMSSSSSBBBBSBBBBABBBBBBBBBBBBBBBBBBBBBBBBBBBAAABBBBBBBAAAAAAAAAAAAAAAAAAAAAAAAAAAAAAPPP
PPPAAAAAAAASSSSSSSSBBBSSSBBBBAABBBBBBBBBBBBBBBBBBBBBKBBBBBAABBBKBAAAAAAAAAAAAAAAAAAAAAAAAAAAAAAAAPPP
PPPAAAAAAAAAASSSSSSSSSSSAAAAAAAAAAAAABBBBBBBBBBBBBBTAAABBBBBBBBBBAAAAAAAAAAAAAAAAAAAAAAAAAAAAAAAAPPP
PPPAAAAAAAAAAAAAAASSSSSSAAAAAAAAAAAAAABBBBBAABBBBBBBAAAAAAAABBBAAAAAAAAAAAAAAAAAAAAAAAAAAAAAAAAAAPPP
PPPAAAAAAAAAAAAAAAAAAAAAAAAAAAAAAAAAAAAAAAAAABBBBBTTAAAAAAAAAAAAAAAAAAAAAAAAAAAAAAAAAAAAAAAAAAAAAPPP
PPPAAAAAAAAAAAAAAAAAAAAAAAAAAAAAAAAAAAAAAAAAAXBBBDTAAAAAAAAAAAAAAAATTAAAAAAAAAAAAAAAAAAAAAAAAAAAAPPP
PPPAAAAAAAAAAAAAAAAAAAAAAAAAAAAAAAAAAAAAAAAAAAAAABTAAAAAAAAAAAAAAAAAAAAAAAAAAAAAAAAAAAAAAAAAAAAAAPPP
PPPAAAAAAAAAAAAAAAAAAAAAAAAAAAAAAAAAAAAAAAAAAAAAAAAAAAAAAAAAAAAAAAAAAAAAAAAAAAAAAAAAAAAAAAAAAAAAAPPP
PPPAAAAAAAAAAAAAAAAAAAAAAAAAAAAAAAAAAAAAAAAAAAAAAAAAAAAAAAAAAAAAAAAAAAAAAAAAAAAAAAAAAAAAAAAAAAAAAPPP
PPPAAAAAAAAAAAAAAAAAAAAAAAAAAAAAAAAAAAAAAAAAAAAAAAAAAAAAAAAAAAAAAAAAAAAAAAAAAAAAAAAAAAAAAAAAAAAAAPPP
PPPAAAAAAAAAAAAAAAAAAAAAAAAAAAAAAAAAAAAAAAAAAAAAAAAAAAAAAAAAAAAAAAAAAAAAAAAAAAAAAAAAAAAAAAAAAAAAAPPP
PPPPPPPPPPPPPPPPPPPPPPPPPPPPPPPPPPPPPPPPPPPPPPPPPPPPPPPPPPPPPPPPPPPPPPPPPPPPPPPPPPPPPPPPPPPPPPPPPPPP
PPPPPPPPPPPPPPPPPPPPPPPPPPPPPPPPPPPPPPPPPPPPPPPPPPPPPPPPPPPPPPPPPPPPPPPPPPPPPPPPPPPPPPPPPPPPPPPPPPPP
PPPPPPPPPPPPPPPPPPPPPPPPPPPPPPPPPPPPPPPPPPPPPPPPPPPPPPPPPPPPPPPPPPPPPPPPPPPPPPPPPPPPPPPPPPPPPPPPPPPP
